
NO textures/netherrack_01.xpm
SO textures/netherrack_02.xpm
WE textures/netherrack.xpm
EA textures/netherrack.xpm

111111111111111
100000000000001
101111101111101
100000100000001
101110101011101
1000100N0000001
111111101111111
111111101111111                        
100000000000001                     
1011111011111011111     
10000010000000000001                
1011101110111011111     
1100010000000001         
111111111111111