111111111111111
1W0000000000001
111101111110101
100001000010001
101111011111101
100000000000001
111111111111111
