111111111111111
100000000000001
101111111110101
101000000000001
101011111110101
10000000000S001
111111111111111
