11111111111111111111111111
10111110001111000111100001
10100000001000000100010001
10100000001000000100010001
10111100001111000111100001
101000000011110W0100100001
10100000001000000100010001
10100000001000000100010001
10100000001111000100010001
11111111111111111111111111