1111111111111111111111111111111111111
10111110000011110000011111000100001001
10100000000010001000010001000100001001
10100000000010001000010001000110001001
101111000000111100N0011111000101001001
10100000000010010000010001000101111001
10100000000010001000010001000100011001
10100000000010001000010001000100001001
10100000000010001000010001000100001001
11111111111111111111111111111111111111